XXXXXXXXXXXXXXX
P         X   X
X X XXXXX X XXX
X X X   X X   X
X X X XXX X X X
X X X     X X X
X X X XXXXXXX X
X X X X     X X
XXX X X XXX X X
X   X X   X X X
X XXX XXX X X X
X X   X   X X X
X X XXX XXX X X
X X     X     K
XXXXXXXXXXXXXXX
